20
15
0 0 0 0 0 0 0 0 0 0 0 0 0 0 0 0 0 0 0 0 
12 12 12 12 12 12 12 12 12 12 12 12 12 0 0 0 0 0 0 0 
0 0 0 0 0 0 0 0 0 0 0 0 12 12 12 12 12 12 12 12 
0 0 0 0 0 0 0 0 0 0 0 0 0 0 0 0 0 0 0 12 
0 0 0 0 0 0 0 0 0 0 0 0 0 0 0 0 0 0 0 0 
0 0 0 0 0 23 24 24 24 24 25 10 10 10 10 10 10 10 10 0 
0 23 24 25 0 0 0 0 0 0 0 21 21 21 21 21 21 7 0 0 
0 0 0 0 0 0 0 0 0 0 0 22 22 22 22 22 22 7 0 0 
0 0 0 0 0 0 0 0 0 0 0 22 22 22 22 22 22 7 0 0 
0 0 0 0 0 0 0 0 0 0 0 22 22 22 22 22 22 7 0 0 
0 0 0 0 0 0 0 0 0 0 0 22 22 22 22 22 22 7 0 0 
0 0 0 0 0 0 0 0 0 0 0 22 22 22 22 22 22 7 0 0 
0 0 0 0 0 0 0 0 0 0 0 22 22 22 22 22 22 7 0 0 
0 0 0 0 0 0 0 0 0 0 0 22 22 22 22 22 22 7 0 0 
0 0 0 0 0 0 0 0 0 0 0 0 0 0 0 0 0 0 0 0 
